100 100 100 100 100 100 100 100 100 100 100 100 100 100
100 100 100 100 100 100 100 100 100 100 100 100 100 100
100 100 100 100 100 100 100 100 100 100 100 100 100 100
100 100 100 100 100 100 101 102 101 100 100 100 100 100
100 100 100 100 100 100 102 001 102 100 100 100 100 100
100 100 100 101 102 102 102 006 102 102 102 101 100 100
100 100 100 103 001 000 001 004 001 006 004 102 100 100
100 100 100 101 102 102 102 102 102 102 102 101 100 100
100 100 100 100 100 100 100 100 100 100 100 100 100 100
100 100 100 100 100 100 100 100 100 100 100 100 100 100