101 102 101 100 100 100 100 100 100 100 100 100 101 102
100 101 102 101 100 100 100 100 100 100 100 101 102 101
100 100 101 102 101 100 100 100 100 100 101 102 101 100
100 100 100 101 102 102 102 102 102 102 102 101 100 100
100 100 100 100 102 000 001 002 003 000 102 100 100 100
100 100 100 100 102 000 002 003 001 000 102 100 100 100
100 100 100 101 102 102 102 102 102 102 102 101 100 100
100 100 101 102 101 100 100 100 100 100 101 102 101 100
100 101 102 101 100 100 100 100 100 100 100 101 102 101
101 102 101 100 100 100 100 100 100 100 100 100 101 102