101 101 101 101 101 101 101 101 101 101 101 101 101 101
101 100 100 100 100 100 100 100 100 100 100 100 100 103
102 100 100 100 100 100 106 105 106 100 100 100 100 101
101 100 100 100 106 105 104 002 104 105 106 100 100 102
103 100 106 105 104 007 015 005 012 009 105 106 100 101
101 100 105 000 000 009 012 002 015 007 005 105 100 103
102 100 106 105 000 105 105 105 105 105 105 106 100 101
101 100 100 106 105 106 100 100 100 100 100 100 100 102
103 100 100 100 100 100 100 100 100 100 100 100 100 101
101 101 101 101 101 101 101 101 101 101 101 101 101 101
