112 100 112 100 112 100 112 100 112 100 112 100 112 100
100 112 100 112 100 112 100 112 100 112 100 112 100 112
112 100 117 117 117 117 117 117 117 117 117 117 112 100
100 112 117 014 000 000 000 000 000 008 011 117 100 112
112 100 112 117 014 000 000 000 011 117 117 100 112 100
100 112 100 112 117 014 000 008 117 112 100 112 100 112
112 100 112 100 112 117 000 117 112 100 112 100 112 100
100 112 100 112 100 112 117 112 100 112 100 112 100 112
112 100 112 100 112 100 112 100 112 100 112 100 112 100
100 112 100 112 100 112 100 112 100 112 100 112 100 112
