100 100 100 100 100 100 100 100 100 100 100 100 100 100
100 100 100 100 100 100 100 100 100 100 100 100 100 100
100 100 100 100 102 102 102 102 102 102 102 100 100 100
100 100 100 100 102 007 002 000 005 006 102 100 100 100
100 100 100 102 102 102 102 000 102 102 102 100 100 100
100 100 100 102 000 000 002 007 006 005 102 100 100 100
100 100 100 102 102 000 102 102 102 102 102 100 100 100
100 100 100 100 102 102 102 100 100 100 100 100 100 100
100 100 100 100 100 100 100 100 100 100 100 100 100 100
100 100 100 100 100 100 100 100 100 100 100 100 100 100