100 100 100 100 100 100 100 100 100 100 100 100 100 100
104 100 100 100 100 100 100 100 100 100 100 100 100 104
102 104 100 104 104 100 104 104 100 104 104 100 104 102
103 102 105 105 105 105 105 105 105 105 105 105 105 103
102 103 105 001 014 000 000 000 000 000 014 015 105 102
103 102 105 101 001 014 000 000 000 001 015 101 105 103
102 103 105 101 101 101 101 000 101 101 101 101 105 102
103 104 105 105 105 105 105 105 105 105 105 105 105 103
104 100 104 100 104 100 104 100 104 100 104 100 104 104
100 100 100 100 100 100 100 100 100 100 100 100 100 100