100 100 100 100 100 100 100 100 100 100 100 100 100 100
100 100 100 100 100 100 100 100 100 100 100 100 100 100
100 100 100 101 101 101 101 101 101 101 101 100 100 100
100 100 100 101 000 000 000 008 000 001 101 100 100 100
100 100 100 101 000 004 000 010 000 008 101 100 100 100
100 100 100 101 004 001 000 102 000 010 101 100 100 100
100 100 100 101 101 004 101 101 101 101 101 100 100 100
100 100 100 101 101 101 101 100 100 100 100 100 100 100
100 100 100 100 100 100 100 100 100 100 100 100 100 100
100 100 100 100 100 100 100 100 100 100 100 100 100 100
