100 100 100 100 100 100 100 100 100 100 100 100 100 100
100 100 100 100 100 100 100 100 100 100 100 100 100 100
100 100 100 102 102 102 102 102 102 102 102 100 100 100
100 100 100 102 000 000 000 000 005 000 102 100 100 100
100 100 100 102 000 000 000 000 102 000 102 100 100 100
100 100 100 102 000 000 000 000 102 000 102 100 100 100
100 100 100 102 005 002 000 000 000 002 102 100 100 100
100 100 100 102 102 102 102 005 102 102 102 100 100 100
100 100 100 100 100 100 102 102 102 100 100 100 100 100
100 100 100 100 100 100 100 100 100 100 100 100 100 100