105 100 105 100 107 000 007 012 000 114 105 100 105 100
100 105 100 105 114 000 012 013 012 110 100 105 100 105
105 100 105 100 108 000 105 100 116 115 105 100 105 100
100 105 100 105 115 000 100 105 114 105 100 105 100 105
105 100 105 100 109 000 000 000 108 100 105 100 105 100
100 105 100 105 116 000 100 013 114 105 100 105 100 105
105 100 105 100 110 000 105 100 109 100 105 100 105 100
100 105 100 105 115 000 000 012 107 105 100 105 100 105
105 100 105 100 109 007 114 110 116 100 105 100 105 100
100 105 100 105 107 115 107 105 100 105 100 105 100 105
