111 113 112 117 111 111 113 112 117 111 117 117 113 117
111 111 113 112 117 111 117 117 113 117 112 113 113 112
111 111 113 100 100 100 100 100 100 100 100 117 113 117
111 111 111 100 000 000 000 000 000 006 100 117 113 117
111 111 113 100 000 000 000 000 000 008 100 113 113 112
111 111 113 100 000 000 000 000 000 100 100 113 112 117
117 112 111 100 008 006 000 000 000 000 100 112 113 113
111 111 113 100 100 100 100 000 008 100 100 117 113 117
117 111 113 112 117 111 100 100 100 100 111 111 113 112
111 111 113 112 117 111 117 117 111 113 112 117 113 117
