100 100 100 000 014 006 007 006 000 000 100 100 100 100
100 100 100 000 006 007 013 012 007 000 100 100 100 100
100 100 100 000 104 101 101 103 104 000 100 100 100 100
100 100 100 000 000 102 101 106 000 000 100 100 100 100
100 100 100 110 000 000 105 000 000 108 100 100 100 100
100 100 100 100 107 000 000 000 100 100 100 100 100 100
100 100 100 100 100 100 000 109 100 100 100 100 100 100
100 100 100 100 100 111 014 114 100 100 100 100 100 100
100 100 100 100 100 109 013 112 100 100 100 100 100 100
100 100 100 100 100 113 012 117 100 100 100 100 100 100
