100 100 100 100 100 100 100 100 100 100 100 100 100 100
100 100 100 100 100 100 100 100 100 100 100 100 100 100
100 100 105 105 105 105 105 105 105 105 105 105 100 100
100 100 105 000 000 000 000 000 000 000 000 105 100 100
100 100 105 000 000 000 000 000 000 000 000 105 100 100
100 100 105 006 010 000 000 000 000 010 006 105 100 100
100 100 105 105 105 000 105 105 000 105 105 105 100 100
100 100 100 100 105 105 105 105 105 105 100 100 100 100
100 100 100 100 100 100 100 100 100 100 100 100 100 100
100 100 100 100 100 100 100 100 100 100 100 100 100 100