100 100 100 100 100 101 100 101 100 101 100 100 100 100
100 100 100 100 101 100 101 100 101 100 101 100 100 100
100 100 100 101 100 101 100 101 100 101 100 101 100 100
100 100 101 100 102 102 102 102 102 102 102 100 101 100
100 101 100 102 000 000 000 000 000 000 000 102 100 101
101 100 101 102 001 000 000 000 001 000 001 102 101 100
100 101 100 101 102 102 102 000 102 102 102 101 100 101
100 100 101 100 101 100 101 102 101 100 101 100 101 100
100 100 100 101 100 101 100 101 100 101 100 101 100 100
100 100 100 100 101 100 101 100 101 100 101 100 100 100