101 102 101 102 101 102 101 102 101 102 101 102 101 102
102 101 102 101 102 101 102 101 102 101 102 101 102 101
101 102 101 102 000 001 000 000 105 000 000 102 101 102
102 101 102 100 100 100 000 000 100 100 100 100 102 101
101 102 101 102 000 000 105 000 000 000 000 102 101 102
102 101 102 101 000 002 003 000 006 007 000 101 102 101
101 102 101 102 000 003 004 000 005 006 000 102 101 102
102 101 102 101 002 004 001 000 001 005 007 101 102 101
101 102 101 102 101 102 101 102 101 102 101 102 101 102
102 101 102 101 102 101 102 101 102 101 102 101 102 101
