000 100 000 100 000 100 000 100 000 100 000 100 000 100
100 000 100 000 100 000 100 000 100 000 100 000 100 000
000 100 107 100 107 100 110 100 108 100 107 100 000 100
100 000 100 001 000 000 000 000 007 000 000 109 100 000
000 100 108 114 009 000 007 000 009 000 009 100 000 100
100 000 100 115 114 007 009 000 007 000 001 107 100 000
000 100 110 114 116 115 007 000 009 000 009 100 000 100
100 000 100 107 100 109 100 110 100 108 100 109 100 000
000 100 000 100 000 100 000 100 000 100 000 100 000 100
100 000 100 000 100 000 100 000 100 000 100 000 100 000
