100 100 100 100 100 100 100 100 100 100 100 100 100 100
100 101 101 101 101 101 101 101 101 101 101 101 100 100
100 101 000 006 000 000 000 000 000 006 000 101 100 100
100 101 006 013 007 000 000 000 013 007 006 101 100 100
100 101 102 102 102 000 000 000 103 103 103 101 100 100
100 101 000 000 000 000 000 000 000 000 000 101 100 100
100 101 000 000 000 000 006 000 000 000 000 101 100 100
100 101 007 013 000 000 101 000 000 007 013 101 100 100
100 101 101 101 000 101 101 101 000 101 101 101 100 100
100 100 100 101 101 101 100 101 101 101 100 100 100 100
